1111111111111111111111
100P000C00000000000011
101111111111111100M011
1011111111111111000011
1000000000000000000011
1000001111111111110111
100M001111111111100111
1000000000MC0000000111
1011111111111111000011
100000000000C000001E11
1111111111111111111111