11111111111111111111111111111111111111111111
100P00000000C0000000000000000000000C00000001
10011111111111110000000000001111111111111001
10000000M000000000000C000000000000M000000001
1MM11111111111110000000000001111111111111MM1
10000000C000000000000000000000C0000000000E01
11111111111111111111111111111111111111111111