11111111111111
10P000C0000001
111000CC0C0E01
11111111111111