11111111111111111111
10P000C0000000000001
11111111111111100M01
11111111111111100001
10000000000000000001
10000111111111111111
10M00111111111111111
1000000000C000000001
111111111111111000M1
10000000000C000000E1
11111111111111111111