11111111111111111111
10P000C0000000000001
11111111111111100001
11111111111111100001
10000000000000000001
10000111111111111111
10000111111111111111
1000000000C000000001
111111111111111000C1
100000000000000000E1
11111111111111111111