11111111111111111111111111111
11000000000P00000000000000001
10010000000000000000000000001
1CCCCCCC000000000000000000001
10000000000000000000000000E01
11111111111111111111111111111